%%%%%%%%%%%%%%%%%%%%%
%                  P%
%                   %
%                   %
%                   %
%                   %
%                   %
%                   %
%                   %
%.                  %
%%%%%%%%%%%%%%%%%%%%%