%%%%%%%%%%%%%%%%%%%%%%%%%%%
%          %% % %%       P%
% % %%%%%%%%    %%% %%%%%%%
% % %        %%     %%% %%%
% %   %%%%%%%%%%% %       %
% % %  %%%      % %%% %%% %
% % %% %   %% %%%   %   % %
% % %%   %  %%%%%% %% % % %
% %  % % % %%%   %%%% % %%%
%.% %% % %     %    % %   %
%%%%%%%%%%%%%%%%%%%%%%%%%%%
