%%%%%%%%%%%%%%%%%%%%%%%%%
% %  %% % %  %     % %%P%
% % %%      %% %% %% %% %
%      %%%%     %%%%  % %
%%% %% % %%%% %  % % %% %
% .  %     %%%%%%% % %% %
%%% %%% % %% % % % %    %
%    %% %            %%%%
% % %%%%%%% %%%%%% %    %
%%%     %%    %%%%%%%%%%%
%   % %  % %% .   % %%  %
%% %% % %%%%  % %      %%
%% %  %   %% %% %% % %  %
%  %% %% %%% %%  % % % %%
%% %%%%    %  %% % %%%%%%
%    %%% %%%%%%% %  % % %
%%% %%     %%%%  %%     %
%    %%% %    %%  %%%% %%
%%% %%%%%%% %  % %%  .  %
%        %% % %%%%  % %%%
% %%%% %%%%%%.   % %%   %
%  %%      %%%% %% %% % %
% %%%% %%%%% %% %% %% % %
%.%%   .     %%  % %  % %
%%%%%%%%%%%%%%%%%%%%%%%%%
