%%%%%%%%%%%%%%%%%%%%%%%%%%%%%%
% % % % %%  % .%%   %% %% % P%
%  .     %%.. %%  %%%  %%   %%
%%%%% %%%%%%% %%% . %%  %%%  %
% % %  %%% %   %% %%%%%.%%  %%
%     %% % %% %%%    %%  %%  %
%%% %. %  .%% %%  % %%%%  % %%
% %%%% %%% %% %  %%%%% %% %  %
% %% % %%   % %% % % % %  % %%
% .     %%%.%.%% % % % % %%. %
%%%%%%% %   %.%      % %  % %%
%%%%%%    %   %%% %%%%. .%%  %
%    %% % % %     % %%%% .  %%
%%%% .. %%%%%% %% %  % % %%%%%
%.   %% %%     %%   %%  .  % %
%%% %%   %%%%.%%  %.   %%%   %
%   .%% %%     %% %% %   % % %
%%%%%%%%% .%%.%%%%%  %% %%%% %
%%%  ..   %%%%%% %  %%     % %
% %%%%%.%%%% %     %%%% %% % %
%  %    %%     %%%.   %. %%% %
%% %%% %%% % %%%.  %% %% G %%%
%G.. . %%  %%%%%%%  %  % %%%%%
% %%%%  %%%%%%    .%%.%%     %
% %    %%    %%%% %%%%%  %% %%
%%%%% %%%%%%.% % .   %%%  %%%%
%%%   %.   .     %.%  %% %%% %
%   % %%%%% % % %% %%  %     %
%.% % %     % % %%  %% % % % %
%%%%%%%%%%%%%%%%%%%%%%%%%%%%%%
