%%%%%%%%
%P     %
%      %
%      %
%      %
%      %
%      %
%%%%%% %
%.     %
%%%%%%%%